WWWWWWWWWWWWWWWWWWWWWWWW
WWWWWWWPHPPWWWWWWWWWWWWW
WWWWPPPPWWPWWWWWWWWWWWWW
WWWWPWWWWWPWWWWWWPPPPPPS
WWWWPWWWWWPWWWWWWHWWWWWW
WWWWPWWWWWPPPWWWPPWWWWWW
WWWWHWWWWWPPHWWWPWWWWWWW
FPPPPWWWWWWWPPPPPWWWWWWW
WWWWWWWWWWWWWWWWWWWWWWWW
WWWWWWWWWWWWWWWWWWWWWWWW
WWWWWWWWWWWWWWWWWWWWWWWW
WWWWWWWWWWWWWWWWWWWWWWWW